MMMMMMMMMMMMMMJ
WWWWWWWWWWWWWWW
WGGGGGG.GGDBBGW
WGGGBBGG..GGGDW
WGBRBBGDGGG.GGW
WGGGGBBGGBG.GGW
WBG.DGGGGGGGGDW
WGGGGGGBGGGGEGW
WWWWWWWWWWWWWWW
